################
#              #
#              #
#      P       #
################